1, 2, 3, 2, 3, 2, 3, 2, 3, 2, 3, 2, 3, 2, 3, 22, 364, 364, 364, 364,
1, 0, 0, 0, 0, 0, 307, 307, 307, 307, 0, 0, 0, 0, 0, 4, 364, 364, 364, 364,
1, 0, 0, 0, 0, 212, 212, 212, 212, 0, 0, 0, 0, 0, 0, 4, 364, 364, 364, 364,
1, 0, 0, 0, 0, 212, 212, 212, 212, 0, 0, 0, 0, 0, 0, 4, 364, 364, 364, 364,
1, 0, 0, 0, 0, 212, 212, 212, 212, 0, 0, 0, 0, 0, 0, 4, 364, 364, 364, 364,
1, 0, 0, 0, 0, 212, 212, 212, 212, 0, 0, 0, 0, 0, 0, 4, 364, 364, 364, 364,
1, 0, 0, 0, 0, 212, 212, 212, 212, 0, 0, 0, 0, 0, 0, 4, 364, 364, 364, 364,
1, 0, 0, 0, 0, 212, 212, 212, 212, 0, 0, 0, 0, 0, 0, 4, 364, 364, 364, 364,
1, 0, 0, 0, 0, 212, 212, 212, 212, 0, 0, 0, 0, 0, 0, 22, 364, 364, 364, 364,
1, 0, 0, 0, 0, 212, 212, 212, 212, 0, 0, 0, 0, 0, 0, 2, 3, 2, 3, 22,
1, 0, 0, 0, 0, 212, 212, 212, 212, 212, 0, 212, 212, 0, 0, 0, 0, 0, 0, 22,
1, 0, 0, 0, 0, 212, 212, 212, 212, 212, 0, 212, 212, 212, 0, 0, 0, 0, 0, 22,
19, 0, 0, 0, 0, 212, 212, 212, 212, 0, 0, 0, 212, 212, 0, 0, 0, 0, 0, 22,
37, 150, 150, 150, 150, 153, 212, 212, 212, 0, 0, 0, 212, 212, 0, 0, 0, 0, 0, 22,
364, 364, 364, 364, 364, 19, 212, 212, 212, 0, 0, 0, 212, 212, 0, 0, 0, 0, 0, 22,
364, 364, 364, 364, 364, 19, 212, 212, 212, 0, 0, 0, 212, 212, 212, 0, 0, 0, 0, 22,
364, 364, 364, 364, 364, 19, 0, 0, 0, 0, 0, 0, 212, 212, 212, 212, 212, 212, 212, 22,
364, 364, 364, 364, 364, 19, 0, 0, 0, 0, 0, 0, 0, 0, 0, 0, 0, 0, 0, 22,
364, 364, 364, 364, 364, 19, 0, 0, 0, 0, 0, 0, 0, 0, 0, 0, 0, 0, 0, 22,
364, 364, 364, 364, 364, 37, 39, 38, 39, 38, 39, 38, 39, 38, 39, 38, 39, 38, 39, 40