293, 293, 293, 293, 293, 293, 293, 293, 293, 293, 293, 293, 293, 293, 293, 293, 293, 293, 293, 293, 293, 293, 293, 293, 293, 293, 293, 293, 293, 293, 293, 293, 293, 293, 293, 293, 293, 293, 293, 293, 293, 293, 293, 293, 293, 293, 293, 293, 293, 293,
293, 255, 255, 255, 255, 255, 255, 255, 255, 255, 255, 255, 255, 195, 255, 255, 255, 255, 195, 255, 255, 195, 255, 255, 255, 255, 255, 255, 255, 255, 195, 255, 255, 195, 255, 255, 255, 255, 255, 255, 255, 255, 255, 255, 255, 255, 255, 255, 255, 293,
293, 255, 257, 255, 255, 268, 255, 255, 255, 255, 257, 255, 255, 177, 255, 255, 268, 255, 177, 255, 255, 177, 255, 255, 195, 255, 255, 195, 255, 255, 177, 257, 255, 177, 255, 255, 195, 255, 255, 255, 255, 255, 255, 255, 255, 255, 255, 255, 255, 293,
293, 255, 255, 255, 255, 255, 255, 255, 257, 255, 255, 255, 255, 177, 255, 255, 255, 255, 177, 255, 255, 177, 255, 255, 177, 255, 255, 177, 255, 255, 177, 255, 255, 177, 268, 255, 177, 255, 255, 255, 255, 255, 255, 255, 255, 255, 255, 255, 255, 293,
293, 255, 255, 255, 255, 255, 255, 255, 255, 255, 255, 268, 255, 177, 255, 255, 255, 177, 177, 255, 255, 177, 255, 255, 177, 255, 257, 177, 255, 255, 177, 257, 255, 177, 257, 255, 177, 255, 255, 255, 255, 255, 255, 255, 255, 255, 255, 255, 255, 293,
293, 255, 255, 255, 257, 255, 255, 255, 255, 255, 255, 255, 255, 177, 255, 255, 255, 177, 177, 255, 255, 177, 255, 255, 177, 255, 268, 177, 255, 255, 177, 255, 255, 177, 255, 255, 177, 255, 255, 255, 255, 255, 255, 255, 255, 255, 255, 255, 255, 293,
293, 255, 255, 255, 255, 255, 257, 255, 255, 255, 255, 268, 255, 177, 255, 255, 255, 268, 177, 255, 255, 177, 268, 255, 177, 255, 255, 177, 257, 255, 177, 255, 255, 177, 255, 257, 177, 255, 255, 255, 255, 255, 255, 255, 255, 255, 255, 255, 255, 293,
293, 255, 255, 268, 255, 255, 255, 255, 255, 255, 255, 255, 255, 177, 255, 255, 255, 255, 177, 255, 255, 177, 255, 255, 177, 255, 255, 177, 255, 255, 177, 255, 255, 177, 255, 255, 177, 255, 255, 255, 255, 255, 255, 255, 255, 255, 255, 255, 255, 293,
293, 255, 255, 255, 255, 255, 255, 255, 257, 255, 255, 255, 255, 177, 255, 255, 255, 255, 255, 255, 255, 255, 255, 255, 177, 255, 255, 177, 255, 255, 255, 255, 255, 255, 255, 255, 177, 255, 255, 255, 255, 255, 255, 255, 255, 255, 255, 255, 255, 293,
293, 255, 255, 255, 255, 255, 255, 268, 255, 255, 255, 257, 255, 255, 111, 112, 255, 255, 255, 255, 255, 255, 255, 255, 255, 255, 255, 255, 255, 255, 255, 255, 255, 255, 255, 255, 255, 255, 255, 255, 255, 255, 255, 255, 255, 255, 255, 255, 255, 293,
293, 255, 255, 255, 257, 255, 255, 255, 255, 255, 255, 255, 255, 255, 255, 255, 255, 255, 255, 255, 255, 255, 255, 255, 255, 255, 255, 255, 255, 255, 255, 255, 255, 255, 255, 255, 255, 255, 255, 255, 255, 255, 255, 255, 255, 255, 255, 255, 255, 293,
293, 255, 255, 255, 255, 255, 255, 255, 255, 255, 257, 255, 255, 255, 255, 255, 255, 255, 255, 255, 255, 255, 255, 255, 255, 255, 255, 255, 255, 255, 255, 255, 255, 255, 255, 255, 255, 255, 255, 255, 255, 255, 255, 255, 255, 255, 255, 255, 255, 293,
293, 255, 255, 255, 255, 255, 255, 255, 255, 255, 255, 255, 255, 255, 255, 255, 255, 255, 255, 255, 268, 255, 255, 255, 255, 255, 255, 255, 255, 255, 255, 255, 255, 255, 255, 255, 255, 255, 255, 255, 255, 255, 255, 255, 255, 255, 255, 255, 255, 293,
293, 255, 255, 255, 255, 268, 255, 255, 255, 255, 255, 255, 255, 257, 255, 255, 255, 255, 255, 255, 255, 255, 255, 255, 255, 255, 255, 255, 255, 255, 255, 255, 255, 255, 255, 255, 255, 255, 255, 255, 255, 255, 255, 255, 255, 255, 255, 255, 255, 293,
293, 255, 255, 255, 255, 255, 255, 255, 255, 255, 268, 255, 255, 255, 255, 255, 255, 255, 255, 255, 255, 255, 255, 255, 255, 255, 255, 255, 255, 255, 255, 255, 255, 255, 255, 255, 268, 255, 255, 255, 255, 255, 255, 255, 255, 255, 255, 255, 255, 293,
293, 255, 255, 255, 255, 255, 255, 255, 255, 255, 255, 255, 255, 255, 255, 255, 268, 255, 255, 255, 255, 255, 255, 255, 255, 255, 255, 255, 255, 255, 255, 255, 255, 255, 255, 255, 255, 255, 255, 255, 255, 255, 255, 255, 255, 255, 255, 255, 255, 293,
293, 255, 255, 255, 255, 255, 255, 255, 255, 255, 255, 255, 255, 255, 257, 255, 255, 255, 255, 255, 255, 268, 255, 255, 255, 255, 255, 255, 255, 255, 255, 255, 255, 255, 255, 255, 255, 255, 255, 255, 255, 255, 255, 255, 255, 255, 255, 255, 255, 293,
293, 255, 255, 255, 255, 255, 255, 255, 255, 255, 255, 255, 255, 255, 255, 255, 255, 255, 255, 255, 255, 255, 257, 255, 255, 255, 255, 257, 255, 255, 255, 255, 268, 255, 255, 255, 255, 255, 255, 255, 255, 255, 255, 255, 255, 255, 255, 255, 255, 293,
293, 255, 255, 268, 255, 255, 255, 255, 255, 255, 255, 255, 255, 255, 255, 255, 257, 255, 268, 255, 255, 255, 255, 255, 255, 255, 255, 255, 255, 255, 255, 255, 255, 255, 255, 255, 255, 255, 255, 255, 255, 268, 255, 255, 255, 255, 255, 255, 255, 293,
293, 255, 255, 255, 255, 255, 255, 268, 255, 255, 255, 255, 255, 255, 255, 255, 255, 255, 255, 255, 255, 255, 255, 255, 255, 255, 255, 255, 255, 255, 255, 255, 257, 255, 255, 257, 255, 255, 255, 255, 255, 255, 255, 255, 255, 255, 255, 255, 255, 293,
293, 255, 255, 255, 255, 255, 255, 255, 255, 255, 255, 268, 255, 255, 255, 255, 255, 255, 255, 255, 255, 255, 257, 255, 255, 255, 255, 255, 255, 255, 255, 255, 255, 255, 255, 255, 255, 255, 255, 255, 255, 255, 255, 255, 255, 255, 255, 255, 255, 293,
293, 255, 255, 255, 255, 255, 255, 255, 255, 255, 255, 255, 255, 255, 255, 255, 257, 255, 255, 255, 255, 255, 255, 255, 255, 255, 268, 255, 255, 255, 255, 255, 255, 255, 255, 255, 255, 255, 255, 255, 255, 255, 255, 255, 261, 255, 255, 255, 255, 293,
293, 255, 255, 255, 268, 255, 255, 255, 255, 255, 255, 255, 255, 255, 255, 255, 255, 255, 255, 255, 255, 255, 255, 255, 255, 255, 255, 257, 255, 268, 255, 255, 255, 255, 257, 255, 257, 255, 255, 255, 255, 255, 255, 255, 255, 255, 255, 255, 255, 293,
293, 255, 255, 255, 255, 255, 255, 255, 257, 255, 255, 255, 255, 255, 255, 255, 257, 255, 255, 255, 255, 255, 255, 255, 255, 255, 257, 255, 255, 255, 255, 255, 255, 255, 255, 255, 255, 255, 255, 255, 255, 255, 255, 255, 255, 255, 255, 255, 255, 293,
293, 255, 255, 255, 255, 255, 255, 255, 255, 255, 255, 268, 255, 255, 255, 255, 255, 255, 255, 255, 255, 255, 255, 255, 255, 255, 255, 255, 255, 255, 255, 255, 255, 255, 257, 255, 255, 255, 255, 255, 255, 255, 255, 255, 255, 268, 255, 255, 255, 293,
293, 255, 255, 255, 255, 255, 255, 255, 255, 255, 255, 255, 255, 255, 255, 255, 255, 255, 255, 255, 257, 255, 255, 255, 255, 257, 255, 255, 255, 255, 257, 255, 255, 255, 257, 255, 268, 255, 255, 255, 255, 255, 255, 255, 255, 255, 255, 255, 255, 293,
293, 255, 255, 255, 255, 255, 268, 255, 255, 255, 255, 255, 255, 255, 255, 255, 255, 255, 255, 255, 255, 255, 255, 255, 255, 255, 255, 255, 255, 255, 255, 257, 255, 255, 255, 255, 261, 255, 255, 255, 255, 255, 255, 255, 255, 255, 255, 255, 255, 293,
293, 255, 255, 255, 255, 255, 255, 255, 255, 255, 255, 255, 255, 255, 255, 268, 255, 255, 255, 257, 268, 255, 255, 255, 255, 255, 255, 255, 255, 255, 255, 255, 255, 255, 255, 255, 255, 255, 255, 255, 255, 255, 255, 255, 255, 255, 255, 255, 255, 293,
293, 255, 255, 255, 255, 255, 255, 255, 255, 255, 255, 255, 255, 255, 255, 255, 255, 255, 255, 255, 255, 255, 255, 255, 255, 255, 255, 255, 255, 255, 255, 255, 255, 255, 255, 255, 255, 255, 255, 255, 255, 255, 255, 255, 255, 255, 255, 255, 255, 293,
293, 255, 255, 255, 255, 255, 255, 255, 255, 255, 257, 255, 255, 268, 255, 257, 255, 255, 255, 255, 255, 255, 255, 255, 255, 268, 255, 255, 255, 255, 255, 255, 255, 255, 255, 255, 255, 255, 255, 255, 255, 255, 255, 255, 255, 255, 255, 255, 255, 293,
293, 255, 255, 255, 255, 255, 255, 268, 255, 255, 255, 255, 255, 255, 255, 255, 255, 255, 255, 255, 255, 255, 255, 255, 255, 255, 255, 255, 255, 255, 255, 255, 255, 255, 255, 255, 255, 255, 255, 255, 255, 255, 255, 255, 255, 255, 255, 255, 255, 293,
293, 255, 255, 255, 255, 255, 255, 255, 255, 255, 255, 255, 255, 255, 255, 255, 255, 255, 255, 255, 255, 255, 255, 255, 255, 255, 255, 255, 255, 255, 255, 255, 255, 255, 255, 255, 255, 255, 255, 255, 255, 255, 255, 255, 255, 255, 255, 255, 255, 293,
293, 255, 255, 255, 255, 255, 255, 255, 255, 255, 255, 255, 255, 255, 255, 268, 255, 255, 255, 255, 255, 255, 268, 255, 255, 255, 255, 255, 255, 255, 255, 255, 255, 255, 255, 255, 255, 255, 255, 255, 255, 255, 255, 255, 255, 255, 255, 255, 255, 293,
293, 255, 255, 255, 255, 255, 255, 255, 255, 255, 255, 255, 255, 255, 255, 255, 255, 255, 255, 255, 255, 255, 255, 255, 255, 255, 255, 255, 255, 255, 255, 255, 255, 255, 255, 255, 255, 255, 268, 255, 255, 255, 255, 255, 255, 268, 255, 255, 255, 293,
293, 255, 255, 255, 255, 257, 255, 255, 255, 255, 255, 255, 255, 255, 255, 255, 255, 255, 255, 255, 255, 255, 255, 255, 255, 255, 255, 255, 255, 255, 255, 255, 255, 255, 255, 255, 255, 255, 255, 255, 255, 255, 255, 255, 255, 255, 255, 255, 255, 293,
293, 255, 255, 255, 255, 255, 255, 255, 255, 255, 255, 255, 255, 255, 255, 255, 255, 255, 255, 255, 255, 255, 255, 255, 255, 257, 255, 255, 255, 255, 255, 255, 255, 255, 268, 255, 255, 255, 255, 255, 255, 255, 255, 255, 255, 255, 255, 255, 255, 293,
293, 255, 255, 255, 255, 255, 255, 255, 255, 255, 268, 255, 255, 255, 255, 255, 255, 255, 255, 255, 255, 255, 255, 255, 255, 255, 255, 255, 255, 255, 255, 255, 255, 255, 255, 255, 255, 255, 255, 255, 255, 255, 255, 255, 255, 255, 255, 255, 255, 293,
293, 255, 255, 255, 255, 255, 255, 255, 287, 255, 255, 255, 255, 255, 255, 255, 255, 255, 255, 255, 255, 255, 255, 255, 255, 255, 255, 255, 255, 255, 255, 255, 255, 255, 255, 287, 255, 255, 255, 255, 255, 255, 255, 255, 255, 255, 255, 255, 255, 293,
293, 255, 255, 255, 255, 255, 255, 255, 288, 257, 255, 255, 255, 255, 255, 255, 255, 255, 255, 255, 255, 255, 255, 255, 255, 255, 255, 255, 255, 255, 255, 257, 255, 255, 255, 288, 255, 255, 255, 255, 255, 255, 255, 255, 255, 255, 255, 255, 255, 293,
293, 255, 255, 255, 255, 255, 255, 255, 288, 255, 255, 255, 255, 255, 255, 255, 255, 255, 255, 257, 255, 255, 287, 255, 255, 255, 255, 255, 255, 255, 255, 255, 255, 255, 255, 288, 255, 255, 255, 255, 255, 255, 268, 255, 255, 255, 255, 255, 255, 293,
293, 255, 255, 291, 291, 291, 291, 291, 290, 291, 291, 291, 291, 291, 291, 291, 291, 255, 255, 255, 255, 255, 257, 255, 255, 255, 255, 255, 291, 291, 291, 291, 291, 291, 291, 290, 291, 291, 291, 291, 291, 291, 291, 255, 255, 255, 255, 255, 255, 293,
293, 255, 255, 257, 255, 255, 257, 255, 288, 255, 255, 255, 255, 255, 255, 268, 255, 255, 255, 255, 255, 255, 255, 255, 255, 255, 255, 255, 255, 255, 255, 255, 255, 255, 255, 288, 255, 255, 255, 255, 255, 255, 255, 255, 255, 255, 255, 255, 255, 293,
293, 255, 255, 257, 255, 255, 255, 255, 288, 255, 255, 255, 257, 255, 255, 255, 255, 255, 255, 255, 255, 255, 255, 255, 255, 255, 255, 255, 255, 255, 268, 255, 255, 255, 268, 288, 255, 255, 255, 255, 255, 255, 255, 255, 255, 255, 255, 255, 255, 293,
293, 255, 255, 255, 255, 255, 255, 255, 255, 255, 255, 255, 255, 255, 255, 255, 255, 255, 255, 255, 255, 255, 255, 255, 255, 255, 255, 255, 255, 255, 255, 255, 255, 255, 255, 255, 255, 255, 255, 255, 255, 268, 255, 255, 255, 255, 255, 255, 255, 293,
293, 255, 255, 255, 255, 257, 255, 255, 255, 255, 257, 255, 255, 255, 255, 255, 255, 255, 255, 255, 255, 255, 255, 255, 255, 255, 255, 255, 255, 255, 255, 255, 255, 255, 255, 255, 255, 255, 255, 255, 255, 255, 255, 255, 255, 255, 255, 255, 255, 293,
293, 255, 255, 255, 255, 255, 255, 255, 255, 255, 255, 255, 255, 255, 255, 255, 255, 255, 255, 255, 255, 255, 255, 255, 255, 255, 255, 255, 255, 255, 255, 255, 255, 255, 255, 255, 255, 255, 255, 255, 255, 255, 255, 255, 255, 255, 255, 255, 255, 293,
293, 255, 255, 257, 255, 255, 255, 255, 255, 255, 257, 255, 255, 255, 255, 255, 255, 255, 255, 255, 255, 255, 255, 255, 255, 255, 255, 255, 255, 255, 255, 255, 255, 255, 255, 255, 255, 255, 255, 255, 255, 255, 255, 255, 255, 255, 255, 255, 255, 293,
293, 255, 255, 255, 255, 255, 255, 255, 255, 255, 255, 255, 255, 255, 255, 255, 255, 255, 255, 255, 255, 257, 255, 255, 255, 255, 255, 255, 255, 255, 255, 255, 255, 255, 255, 255, 255, 255, 255, 255, 255, 255, 255, 255, 255, 255, 255, 255, 255, 293,
293, 255, 255, 255, 255, 255, 255, 255, 255, 255, 255, 255, 255, 255, 255, 255, 255, 255, 255, 255, 255, 255, 255, 255, 255, 255, 255, 255, 255, 255, 255, 255, 255, 255, 255, 255, 255, 255, 255, 255, 255, 255, 255, 255, 255, 255, 255, 255, 255, 293,
293, 293, 293, 293, 293, 293, 293, 293, 293, 293, 293, 293, 293, 293, 293, 293, 293, 293, 293, 293, 293, 293, 293, 293, 293, 293, 293, 293, 293, 293, 293, 293, 293, 293, 293, 293, 293, 293, 293, 293, 293, 293, 293, 293, 293, 293, 293, 293, 293, 293