0, 0, 0, 0, 0, 0, 0, 0, 0, 0, 0, 0, 0, 0, 0, 0, 0, 0, 0, 0,
0, 5, 113, 113, 113, 110, 110, 110, 110, 110, 110, 110, 118, 118, 118, 118, 118, 118, 115, 0,
0, 113, 110, 112, 113, 113, 113, 113, 113, 113, 113, 113, 113, 113, 113, 113, 110, 110, 118, 0,
0, 113, 110, 113, 154, 113, 113, 118, 118, 118, 110, 110, 113, 113, 113, 113, 115, 118, 118, 0,
0, 113, 110, 113, 133, 113, 113, 113, 113, 113, 113, 113, 113, 113, 113, 113, 115, 118, 115, 0,
0, 110, 154, 113, 110, 113, 115, 115, 115, 115, 115, 115, 115, 115, 115, 113, 115, 118, 115, 0,
0, 110, 154, 113, 110, 118, 115, 0, 0, 0, 172, 0, 0, 0, 115, 113, 115, 118, 115, 0,
0, 110, 154, 112, 118, 110, 115, 0, 0, 0, 172, 0, 0, 0, 115, 118, 115, 118, 115, 0,
0, 154, 154, 154, 118, 110, 115, 0, 0, 0, 172, 0, 0, 0, 115, 113, 115, 110, 115, 0,
0, 154, 154, 154, 154, 118, 115, 0, 0, 0, 172, 0, 0, 0, 115, 113, 115, 110, 115, 0,
0, 154, 154, 154, 154, 118, 115, 115, 115, 0, 172, 0, 0, 115, 115, 113, 115, 110, 115, 0,
0, 113, 113, 154, 154, 154, 115, 115, 115, 115, 115, 115, 115, 115, 154, 154, 115, 110, 115, 0,
0, 154, 154, 154, 154, 154, 115, 115, 115, 154, 118, 118, 118, 118, 154, 118, 154, 115, 115, 0,
0, 154, 113, 154, 154, 154, 115, 115, 115, 154, 154, 154, 115, 154, 154, 118, 154, 154, 154, 0,
0, 154, 154, 154, 154, 154, 120, 115, 113, 115, 110, 110, 154, 154, 115, 115, 115, 115, 154, 0,
0, 154, 154, 154, 120, 154, 154, 154, 154, 154, 154, 154, 154, 154, 154, 154, 154, 154, 154, 0,
0, 154, 154, 120, 120, 120, 120, 120, 115, 113, 113, 113, 120, 120, 110, 110, 110, 120, 120, 0,
0, 154, 154, 120, 113, 120, 120, 115, 115, 120, 120, 120, 120, 120, 120, 120, 120, 120, 120, 0,
0, 154, 154, 154, 154, 113, 113, 120, 120, 120, 120, 120, 120, 120, 120, 120, 120, 120, 120, 0,
0, 0, 0, 0, 0, 0, 0, 0, 0, 0, 0, 0, 0, 0, 0, 0, 0, 0, 0, 0