0, 0, 0, 0, 0, 0, 0, 0, 0, 0, 0, 0, 0, 0, 0, 0, 0, 0, 0, 0, 0, 0, 0, 0, 0, 0, 0, 0, 0, 0, 0, 0, 0, 0, 0, 0, 0, 0, 0, 0, 0, 0, 0, 0, 0, 0, 0, 0, 0, 0, 0, 0, 0, 3, 0,
0, 109, 109, 109, 109, 109, 109, 109, 109, 109, 109, 109, 109, 109, 109, 109, 109, 109, 109, 109, 109, 109, 109, 109, 109, 109, 109, 109, 109, 109, 109, 109, 109, 109, 109, 109, 109, 109, 109, 109, 109, 109, 109, 109, 109, 109, 109, 109, 109, 109, 109, 109, 109, 109, 0,
0, 109, 109, 109, 109, 109, 109, 109, 109, 109, 109, 262, 109, 109, 109, 109, 109, 109, 109, 109, 109, 109, 109, 109, 109, 109, 109, 109, 109, 109, 109, 109, 109, 109, 109, 109, 109, 109, 109, 109, 109, 109, 109, 109, 109, 109, 109, 109, 109, 109, 109, 109, 109, 109, 0,
0, 109, 109, 109, 109, 109, 109, 109, 109, 109, 109, 256, 109, 109, 109, 109, 109, 109, 109, 109, 109, 109, 109, 109, 109, 109, 109, 109, 109, 109, 109, 109, 109, 109, 109, 109, 262, 109, 109, 109, 109, 109, 109, 109, 109, 109, 109, 109, 109, 109, 109, 109, 109, 109, 0,
0, 109, 109, 109, 109, 109, 109, 109, 109, 109, 109, 109, 109, 109, 109, 109, 109, 109, 109, 109, 109, 109, 109, 259, 109, 109, 109, 109, 109, 109, 262, 109, 109, 109, 109, 109, 109, 109, 109, 109, 109, 256, 109, 109, 109, 109, 262, 109, 109, 109, 109, 109, 109, 109, 0,
0, 109, 109, 109, 109, 109, 109, 109, 109, 109, 109, 109, 109, 109, 109, 109, 109, 109, 109, 109, 109, 109, 109, 109, 109, 109, 109, 109, 109, 109, 109, 109, 109, 109, 109, 109, 109, 109, 109, 109, 109, 109, 109, 109, 109, 109, 109, 109, 109, 109, 259, 109, 109, 109, 0,
0, 109, 109, 109, 109, 109, 109, 109, 109, 109, 109, 109, 109, 109, 109, 109, 109, 109, 109, 109, 109, 109, 109, 109, 109, 109, 109, 109, 109, 109, 109, 109, 109, 109, 109, 109, 109, 109, 109, 109, 109, 109, 109, 109, 109, 109, 109, 109, 109, 109, 109, 109, 109, 109, 0,
0, 109, 109, 109, 109, 109, 109, 109, 109, 109, 109, 109, 109, 256, 109, 109, 109, 109, 109, 109, 109, 109, 109, 109, 109, 109, 109, 256, 109, 109, 109, 109, 109, 109, 109, 109, 109, 109, 109, 109, 109, 109, 109, 109, 109, 109, 109, 109, 109, 109, 109, 109, 109, 109, 0,
0, 109, 109, 109, 109, 259, 109, 109, 109, 109, 109, 109, 109, 109, 109, 109, 109, 109, 109, 262, 109, 109, 109, 109, 109, 109, 109, 109, 109, 109, 109, 109, 109, 109, 109, 109, 109, 109, 109, 109, 109, 109, 109, 109, 109, 109, 256, 259, 109, 109, 109, 109, 109, 109, 0,
0, 109, 109, 109, 109, 109, 109, 109, 109, 109, 109, 109, 259, 109, 109, 109, 109, 109, 109, 109, 109, 109, 109, 109, 109, 109, 109, 109, 109, 109, 109, 109, 109, 109, 109, 109, 109, 109, 109, 109, 109, 109, 109, 109, 109, 109, 109, 109, 109, 109, 109, 109, 109, 109, 0,
0, 109, 109, 109, 109, 109, 109, 109, 109, 109, 109, 109, 109, 109, 109, 109, 109, 109, 109, 109, 109, 109, 109, 256, 109, 109, 259, 109, 109, 109, 109, 109, 109, 109, 259, 109, 109, 109, 109, 109, 109, 109, 109, 109, 109, 109, 109, 109, 109, 109, 109, 109, 109, 109, 0,
0, 109, 109, 109, 109, 109, 109, 109, 109, 109, 109, 109, 109, 109, 109, 109, 109, 109, 109, 109, 0, 109, 109, 109, 109, 109, 109, 109, 109, 109, 109, 109, 109, 109, 109, 109, 109, 109, 109, 0, 109, 109, 109, 109, 109, 109, 109, 109, 109, 109, 109, 109, 109, 109, 0,
0, 0, 0, 0, 0, 0, 0, 0, 0, 0, 0, 0, 0, 0, 0, 0, 0, 0, 0, 0, 0, 109, 109, 109, 109, 109, 109, 109, 109, 109, 109, 109, 109, 109, 109, 109, 109, 109, 109, 0, 0, 0, 0, 0, 0, 0, 0, 0, 0, 0, 0, 0, 0, 0, 0,
0, 0, 0, 0, 0, 0, 0, 0, 0, 0, 0, 0, 0, 0, 0, 0, 0, 0, 0, 0, 0, 0, 0, 0, 0, 0, 0, 0, 254, 254, 254, 254, 254, 0, 0, 0, 0, 0, 0, 0, 0, 0, 0, 0, 0, 0, 0, 0, 0, 0, 0, 0, 0, 0, 0,
0, 0, 0, 0, 0, 0, 0, 0, 0, 0, 0, 0, 0, 0, 0, 0, 0, 0, 0, 0, 0, 0, 0, 0, 0, 0, 0, 0, 254, 259, 254, 254, 254, 0, 0, 0, 0, 0, 0, 0, 0, 0, 0, 0, 0, 0, 0, 0, 0, 0, 0, 0, 0, 0, 0,
0, 0, 0, 0, 0, 110, 110, 110, 254, 254, 254, 254, 254, 254, 254, 254, 0, 0, 0, 0, 0, 0, 0, 0, 0, 0, 0, 0, 254, 254, 254, 254, 254, 0, 0, 0, 0, 0, 0, 0, 0, 0, 0, 0, 0, 0, 0, 0, 0, 0, 0, 0, 0, 0, 0,
0, 0, 0, 0, 110, 110, 255, 110, 254, 254, 254, 254, 254, 254, 254, 254, 0, 0, 0, 0, 0, 0, 0, 0, 0, 0, 0, 0, 254, 254, 254, 254, 254, 0, 0, 0, 0, 0, 0, 254, 254, 254, 254, 109, 109, 109, 109, 109, 109, 109, 0, 0, 0, 0, 0,
0, 0, 0, 110, 110, 110, 110, 110, 259, 254, 254, 254, 254, 254, 259, 254, 0, 0, 0, 0, 0, 0, 0, 0, 0, 0, 0, 0, 254, 254, 254, 254, 254, 0, 0, 0, 0, 0, 0, 0, 0, 0, 254, 256, 109, 109, 109, 259, 109, 109, 0, 0, 0, 0, 0,
0, 110, 110, 110, 110, 110, 110, 110, 254, 255, 254, 254, 254, 254, 254, 254, 0, 0, 0, 0, 0, 0, 0, 0, 0, 0, 0, 0, 254, 254, 254, 254, 254, 0, 0, 0, 0, 0, 0, 0, 0, 0, 254, 109, 109, 109, 109, 109, 109, 109, 0, 0, 0, 0, 0,
0, 110, 110, 110, 110, 110, 110, 254, 254, 254, 0, 0, 0, 166, 0, 0, 0, 0, 0, 0, 0, 0, 0, 0, 0, 0, 0, 0, 254, 254, 254, 259, 254, 0, 0, 0, 0, 0, 0, 0, 0, 0, 254, 254, 254, 109, 109, 109, 256, 256, 0, 0, 0, 0, 0,
0, 254, 254, 254, 254, 254, 254, 254, 254, 254, 0, 0, 0, 167, 0, 0, 0, 0, 0, 0, 0, 0, 0, 0, 0, 0, 0, 0, 254, 254, 254, 254, 254, 0, 0, 0, 0, 0, 0, 0, 0, 0, 0, 0, 254, 254, 254, 259, 109, 109, 0, 0, 0, 0, 0,
0, 254, 254, 254, 254, 254, 255, 254, 254, 254, 0, 0, 0, 167, 0, 0, 0, 0, 0, 0, 0, 0, 116, 0, 0, 0, 0, 0, 254, 254, 254, 254, 254, 0, 0, 0, 0, 0, 0, 0, 0, 0, 0, 0, 0, 0, 0, 254, 109, 109, 0, 0, 0, 0, 0,
0, 254, 254, 254, 254, 254, 254, 254, 254, 254, 0, 0, 0, 168, 169, 169, 169, 169, 169, 169, 169, 0, 116, 0, 0, 0, 0, 0, 254, 254, 254, 254, 254, 0, 0, 0, 0, 0, 0, 0, 0, 0, 0, 0, 0, 0, 0, 254, 109, 109, 0, 0, 0, 0, 0,
0, 254, 254, 254, 255, 254, 254, 254, 254, 254, 0, 0, 0, 0, 0, 0, 0, 0, 0, 0, 0, 0, 0, 0, 0, 0, 0, 0, 254, 254, 254, 254, 254, 0, 0, 0, 0, 0, 0, 0, 0, 0, 0, 0, 0, 0, 0, 254, 109, 109, 0, 0, 0, 0, 0,
0, 254, 254, 254, 254, 254, 254, 259, 254, 254, 0, 0, 0, 0, 0, 0, 0, 0, 0, 312, 0, 0, 0, 0, 0, 0, 0, 0, 254, 254, 254, 254, 254, 0, 0, 0, 0, 0, 0, 0, 0, 0, 0, 0, 0, 0, 0, 0, 254, 254, 0, 0, 0, 0, 0,
0, 254, 254, 254, 254, 254, 254, 254, 254, 254, 0, 0, 0, 0, 0, 0, 254, 254, 254, 254, 254, 0, 0, 0, 0, 0, 0, 0, 254, 254, 254, 254, 254, 0, 0, 0, 0, 0, 0, 0, 0, 0, 0, 0, 0, 0, 254, 254, 254, 254, 0, 0, 0, 0, 0,
0, 254, 254, 254, 254, 254, 254, 254, 254, 254, 254, 254, 254, 254, 255, 254, 255, 254, 254, 254, 254, 254, 254, 254, 254, 254, 254, 254, 254, 254, 254, 254, 254, 254, 254, 254, 254, 254, 254, 254, 254, 254, 254, 254, 254, 254, 254, 254, 254, 254, 0, 0, 0, 0, 0,
0, 109, 109, 109, 109, 109, 255, 109, 109, 109, 109, 109, 109, 109, 109, 109, 109, 109, 109, 109, 109, 109, 109, 109, 109, 109, 109, 109, 109, 109, 109, 109, 109, 109, 109, 255, 109, 109, 109, 109, 109, 255, 109, 109, 109, 254, 254, 254, 254, 254, 0, 0, 0, 0, 0,
0, 109, 109, 109, 109, 109, 109, 109, 109, 109, 109, 109, 109, 109, 109, 109, 109, 256, 109, 109, 109, 109, 109, 109, 109, 109, 109, 109, 109, 109, 109, 109, 109, 109, 109, 109, 109, 109, 109, 109, 109, 109, 109, 109, 109, 254, 254, 254, 254, 254, 0, 0, 0, 0, 0,
0, 109, 109, 109, 109, 109, 109, 109, 109, 109, 109, 109, 109, 109, 109, 109, 109, 109, 109, 109, 109, 109, 109, 109, 109, 109, 109, 109, 109, 109, 109, 109, 109, 109, 109, 109, 109, 109, 109, 109, 259, 109, 109, 109, 109, 256, 254, 254, 254, 254, 0, 0, 0, 0, 0,
0, 0, 0, 0, 0, 0, 0, 0, 0, 0, 0, 0, 0, 0, 0, 0, 0, 0, 0, 0, 0, 0, 0, 0, 0, 0, 0, 0, 0, 0, 0, 0, 0, 0, 0, 0, 0, 0, 0, 0, 0, 0, 0, 0, 0, 0, 0, 0, 0, 0, 0, 0, 0, 0, 0,
0, 253, 253, 253, 253, 253, 253, 253, 253, 253, 253, 253, 253, 253, 253, 253, 253, 253, 253, 253, 253, 253, 253, 253, 253, 253, 253, 253, 253, 253, 253, 253, 253, 253, 253, 253, 253, 253, 253, 253, 253, 253, 253, 253, 253, 253, 253, 253, 253, 253, 253, 253, 253, 253, 0,
0, 253, 253, 253, 253, 253, 253, 253, 253, 253, 253, 253, 253, 253, 253, 253, 253, 253, 253, 253, 253, 253, 253, 253, 253, 253, 253, 253, 253, 253, 253, 253, 253, 253, 253, 253, 253, 253, 253, 253, 253, 253, 253, 253, 253, 253, 253, 253, 253, 253, 253, 253, 253, 253, 0,
0, 253, 253, 253, 253, 253, 253, 253, 253, 253, 253, 253, 253, 253, 253, 253, 253, 253, 253, 253, 253, 253, 253, 253, 253, 253, 253, 253, 253, 253, 253, 253, 253, 253, 253, 253, 253, 253, 253, 253, 253, 253, 253, 253, 253, 253, 253, 253, 253, 253, 253, 253, 253, 253, 0,
0, 253, 253, 253, 253, 253, 253, 253, 253, 253, 253, 253, 253, 253, 253, 253, 253, 261, 253, 253, 253, 253, 253, 253, 261, 253, 253, 253, 253, 253, 253, 253, 253, 253, 253, 253, 253, 253, 253, 253, 253, 253, 253, 253, 253, 253, 253, 253, 253, 253, 255, 253, 253, 253, 0,
0, 253, 253, 253, 255, 253, 253, 253, 253, 253, 253, 253, 253, 255, 253, 253, 253, 253, 253, 253, 253, 253, 253, 253, 253, 253, 253, 253, 253, 253, 253, 253, 253, 253, 253, 253, 253, 253, 253, 253, 253, 253, 253, 253, 253, 253, 253, 253, 253, 261, 253, 253, 253, 253, 0,
0, 253, 253, 253, 253, 253, 253, 253, 253, 253, 253, 253, 253, 253, 253, 253, 253, 253, 253, 253, 255, 253, 253, 253, 253, 253, 253, 253, 253, 253, 253, 253, 253, 253, 253, 253, 253, 253, 253, 255, 253, 253, 253, 253, 253, 259, 253, 253, 253, 253, 253, 253, 253, 253, 0,
0, 253, 253, 253, 253, 253, 253, 253, 253, 253, 253, 253, 253, 253, 253, 253, 253, 253, 253, 253, 253, 253, 253, 253, 253, 253, 253, 253, 253, 253, 253, 253, 253, 253, 253, 253, 261, 253, 253, 253, 253, 253, 253, 253, 253, 259, 253, 253, 253, 253, 253, 253, 253, 253, 0,
0, 253, 253, 253, 253, 253, 253, 255, 253, 253, 253, 253, 253, 253, 253, 253, 253, 253, 253, 253, 253, 253, 253, 253, 253, 253, 253, 253, 253, 253, 253, 253, 253, 253, 255, 253, 253, 253, 253, 253, 253, 253, 253, 253, 253, 253, 253, 253, 253, 253, 253, 253, 253, 253, 0,
0, 253, 253, 253, 253, 253, 253, 253, 253, 253, 253, 253, 253, 253, 253, 253, 253, 253, 253, 253, 253, 253, 261, 253, 253, 253, 253, 253, 253, 253, 253, 253, 253, 253, 253, 253, 253, 253, 253, 253, 253, 253, 255, 253, 253, 253, 253, 253, 253, 253, 253, 253, 253, 253, 0,
0, 253, 253, 253, 253, 253, 253, 253, 253, 253, 259, 253, 253, 253, 253, 253, 261, 253, 253, 253, 253, 253, 253, 253, 253, 253, 253, 253, 253, 253, 253, 253, 253, 253, 253, 253, 253, 253, 253, 261, 253, 253, 253, 253, 253, 253, 253, 253, 253, 253, 253, 253, 253, 253, 0,
0, 253, 253, 253, 253, 253, 253, 253, 253, 253, 253, 253, 253, 253, 253, 253, 253, 253, 253, 253, 253, 253, 253, 253, 253, 253, 253, 253, 253, 255, 253, 253, 253, 253, 253, 253, 253, 253, 253, 253, 253, 253, 253, 253, 253, 253, 253, 253, 253, 253, 253, 253, 253, 253, 0,
0, 253, 253, 253, 253, 253, 253, 253, 253, 253, 253, 253, 253, 253, 253, 253, 253, 253, 253, 253, 253, 253, 253, 253, 253, 253, 253, 253, 253, 253, 253, 253, 253, 253, 253, 253, 253, 253, 253, 253, 253, 253, 253, 253, 253, 253, 253, 253, 253, 261, 253, 253, 253, 253, 0,
253, 253, 253, 253, 253, 253, 253, 253, 253, 253, 253, 253, 253, 253, 253, 253, 253, 253, 253, 253, 253, 253, 253, 253, 253, 253, 253, 253, 253, 253, 253, 253, 253, 253, 253, 253, 259, 253, 253, 253, 253, 253, 253, 253, 253, 253, 253, 259, 253, 253, 253, 253, 253, 253, 0,
253, 253, 253, 253, 253, 253, 253, 253, 253, 253, 253, 259, 253, 253, 253, 253, 253, 253, 253, 253, 253, 255, 253, 253, 253, 253, 253, 253, 253, 253, 253, 253, 253, 253, 253, 253, 255, 253, 253, 253, 253, 253, 253, 253, 253, 253, 253, 253, 253, 253, 253, 253, 253, 253, 0,
253, 253, 253, 253, 253, 253, 253, 253, 253, 253, 253, 253, 253, 253, 253, 253, 253, 253, 253, 253, 253, 253, 253, 253, 253, 253, 253, 253, 253, 253, 253, 253, 253, 253, 253, 253, 253, 253, 253, 253, 253, 253, 253, 255, 253, 253, 253, 253, 253, 253, 253, 253, 253, 253, 0,
253, 253, 253, 253, 253, 253, 253, 253, 253, 253, 253, 253, 253, 253, 253, 253, 253, 253, 253, 253, 253, 253, 253, 253, 253, 253, 253, 253, 253, 253, 253, 253, 253, 253, 253, 253, 253, 253, 253, 253, 253, 253, 253, 253, 253, 253, 253, 253, 261, 255, 253, 259, 253, 253, 0,
253, 253, 253, 253, 253, 253, 253, 253, 253, 253, 253, 253, 253, 253, 253, 253, 253, 253, 253, 253, 253, 253, 253, 253, 253, 253, 253, 253, 253, 253, 253, 253, 253, 253, 253, 253, 253, 259, 253, 253, 253, 253, 253, 259, 253, 253, 253, 253, 253, 253, 253, 253, 253, 253, 0,
0, 253, 253, 253, 253, 253, 253, 253, 253, 253, 253, 253, 253, 253, 253, 253, 253, 253, 253, 253, 253, 253, 253, 253, 253, 253, 253, 253, 253, 253, 253, 253, 253, 253, 253, 253, 253, 253, 253, 253, 253, 253, 253, 253, 253, 253, 253, 253, 253, 253, 253, 253, 253, 253, 0,
253, 253, 253, 253, 253, 253, 253, 253, 253, 255, 253, 253, 253, 253, 253, 253, 253, 253, 253, 253, 253, 253, 253, 255, 253, 253, 253, 253, 253, 255, 253, 253, 253, 253, 253, 253, 253, 253, 253, 253, 253, 253, 253, 253, 253, 255, 253, 253, 253, 253, 253, 253, 253, 253, 0,
253, 253, 253, 253, 253, 253, 253, 253, 253, 253, 253, 253, 253, 253, 253, 253, 253, 253, 253, 253, 253, 253, 253, 253, 253, 253, 253, 253, 253, 253, 253, 253, 253, 253, 253, 253, 253, 253, 253, 253, 253, 253, 253, 253, 253, 253, 253, 253, 253, 253, 253, 253, 253, 253, 0,
0, 253, 253, 253, 253, 253, 253, 253, 253, 253, 253, 253, 253, 255, 253, 253, 253, 253, 253, 253, 253, 253, 253, 253, 253, 253, 253, 253, 253, 253, 253, 253, 253, 253, 253, 253, 253, 253, 253, 253, 253, 253, 253, 253, 253, 253, 253, 253, 253, 253, 253, 253, 253, 253, 0,
0, 253, 253, 253, 253, 253, 253, 253, 253, 253, 253, 253, 253, 253, 253, 253, 253, 253, 253, 253, 253, 253, 253, 253, 253, 253, 253, 253, 253, 253, 253, 253, 253, 253, 253, 253, 253, 253, 253, 253, 253, 253, 253, 253, 253, 253, 253, 253, 253, 253, 253, 253, 253, 253, 0,
0, 253, 253, 253, 253, 253, 253, 253, 253, 253, 253, 253, 253, 253, 253, 253, 253, 253, 253, 253, 253, 253, 253, 253, 253, 253, 253, 253, 253, 253, 253, 253, 253, 253, 253, 253, 253, 253, 253, 253, 253, 253, 253, 253, 253, 253, 253, 253, 253, 253, 253, 253, 253, 253, 0,
0, 0, 253, 253, 253, 253, 253, 253, 253, 253, 253, 253, 253, 253, 253, 253, 253, 0, 0, 0, 0, 0, 0, 0, 0, 0, 0, 0, 0, 0, 0, 0, 253, 253, 253, 253, 0, 0, 0, 0, 0, 0, 0, 0, 0, 0, 0, 0, 0, 0, 0, 0, 0, 0, 0