0, 0, 0, 0, 0, 0, 0, 0, 0, 0, 0, 0, 0, 0, 0, 0, 0, 0, 0, 0,
0, 113, 113, 113, 113, 113, 113, 113, 113, 113, 113, 113, 113, 113, 113, 113, 113, 113, 113, 0,
0, 113, 113, 113, 113, 113, 113, 113, 113, 113, 113, 113, 113, 113, 113, 113, 113, 113, 113, 0,
0, 113, 113, 113, 113, 115, 115, 115, 115, 115, 115, 115, 115, 115, 113, 113, 113, 113, 113, 0,
0, 113, 113, 113, 113, 115, 115, 111, 127, 111, 111, 111, 111, 115, 113, 113, 113, 113, 113, 0,
0, 113, 113, 113, 113, 115, 111, 0, 167, 0, 0, 0, 111, 115, 113, 113, 113, 113, 113, 0,
0, 113, 113, 113, 113, 115, 111, 0, 168, 0, 0, 0, 111, 115, 113, 113, 113, 113, 113, 0,
0, 113, 113, 113, 113, 115, 111, 0, 168, 0, 0, 0, 111, 115, 113, 113, 113, 113, 113, 0,
0, 113, 113, 113, 113, 115, 111, 0, 168, 0, 0, 0, 111, 115, 113, 113, 113, 113, 113, 0,
0, 113, 113, 113, 113, 115, 111, 0, 168, 0, 0, 0, 111, 115, 113, 113, 113, 113, 113, 0,
0, 113, 113, 113, 113, 115, 111, 111, 127, 111, 111, 111, 111, 115, 113, 113, 113, 113, 113, 0,
0, 113, 113, 113, 113, 115, 115, 115, 115, 115, 115, 115, 115, 115, 113, 113, 113, 113, 113, 0,
0, 113, 113, 113, 113, 113, 113, 113, 113, 113, 113, 115, 115, 115, 113, 113, 113, 113, 113, 0,
0, 113, 113, 113, 113, 113, 113, 113, 113, 113, 113, 113, 113, 113, 113, 113, 113, 113, 113, 0,
0, 113, 113, 113, 113, 113, 113, 113, 113, 113, 113, 113, 113, 113, 113, 113, 113, 113, 113, 0,
0, 113, 113, 113, 113, 113, 113, 113, 113, 113, 113, 113, 113, 113, 113, 113, 113, 113, 113, 0,
0, 113, 113, 113, 113, 113, 113, 113, 113, 113, 113, 113, 113, 113, 113, 113, 113, 113, 113, 0,
0, 113, 113, 113, 113, 113, 113, 113, 113, 113, 113, 113, 113, 113, 113, 113, 113, 113, 113, 0,
0, 185, 113, 113, 113, 113, 113, 113, 113, 113, 113, 113, 113, 113, 113, 113, 113, 113, 113, 0,
0, 0, 0, 0, 0, 0, 0, 0, 0, 0, 0, 0, 0, 0, 0, 0, 0, 0, 0, 0