0, 0, 0, 0, 0, 0, 0, 0, 0, 0, 0, 0, 0, 0, 0, 0, 0, 0, 0, 0, 0, 0, 0, 0, 0, 0, 0, 0, 201, 202, 203, 202, 203, 202, 203, 202, 203, 202, 203, 204,
0, 0, 0, 0, 0, 0, 0, 0, 0, 0, 0, 0, 0, 0, 0, 0, 0, 0, 0, 0, 0, 0, 0, 0, 0, 0, 0, 0, 201, 0, 0, 0, 0, 0, 0, 0, 0, 0, 0, 204,
201, 202, 202, 202, 202, 202, 202, 202, 202, 202, 202, 202, 202, 202, 202, 202, 202, 202, 203, 204, 0, 0, 0, 0, 0, 0, 0, 0, 201, 0, 0, 0, 0, 0, 0, 0, 0, 0, 0, 204,
201, 0, 0, 0, 0, 0, 0, 0, 0, 0, 0, 0, 0, 0, 0, 0, 0, 0, 0, 204, 0, 0, 0, 0, 0, 0, 0, 0, 201, 0, 0, 0, 0, 0, 0, 210, 0, 0, 0, 204,
201, 0, 0, 0, 0, 0, 0, 0, 0, 0, 0, 0, 0, 0, 0, 0, 0, 0, 0, 204, 0, 0, 0, 0, 0, 0, 0, 0, 201, 0, 0, 0, 210, 207, 207, 207, 206, 207, 207, 208,
201, 0, 0, 0, 0, 0, 0, 0, 0, 0, 0, 0, 0, 0, 0, 0, 0, 0, 0, 204, 0, 0, 0, 0, 0, 0, 0, 0, 201, 0, 0, 0, 204, 0, 0, 0, 0, 0, 0, 0,
201, 0, 0, 0, 0, 0, 0, 0, 0, 0, 0, 0, 0, 0, 0, 0, 0, 0, 0, 204, 0, 0, 0, 0, 0, 0, 0, 0, 201, 0, 0, 0, 204, 0, 0, 0, 0, 0, 0, 0,
201, 202, 202, 202, 202, 202, 202, 202, 203, 0, 202, 202, 202, 202, 202, 202, 202, 202, 203, 204, 0, 0, 0, 0, 0, 0, 0, 0, 201, 0, 0, 0, 204, 0, 0, 0, 0, 0, 0, 0,
201, 265, 265, 265, 284, 284, 284, 284, 284, 0, 0, 284, 284, 284, 284, 265, 265, 265, 265, 204, 0, 0, 0, 0, 0, 0, 0, 0, 201, 203, 0, 203, 204, 0, 0, 0, 0, 0, 0, 0,
201, 0, 0, 0, 0, 267, 270, 270, 270, 0, 0, 270, 270, 270, 0, 0, 0, 0, 0, 204, 0, 0, 0, 0, 0, 0, 0, 0, 201, 0, 0, 0, 204, 0, 0, 0, 0, 0, 0, 0,
201, 265, 265, 265, 265, 266, 270, 270, 270, 0, 270, 270, 270, 270, 281, 265, 265, 265, 265, 204, 0, 0, 0, 0, 0, 0, 0, 0, 201, 0, 0, 0, 204, 0, 0, 0, 0, 0, 0, 0,
201, 0, 0, 0, 0, 267, 270, 270, 270, 0, 270, 270, 270, 270, 0, 0, 0, 0, 0, 202, 203, 202, 203, 202, 202, 203, 202, 203, 202, 0, 0, 0, 204, 0, 0, 0, 0, 0, 0, 0,
201, 0, 0, 0, 0, 267, 283, 283, 283, 0, 283, 283, 283, 283, 0, 0, 0, 0, 0, 0, 0, 0, 0, 0, 0, 0, 0, 0, 0, 0, 0, 0, 204, 0, 0, 0, 0, 0, 0, 0,
201, 0, 0, 0, 0, 267, 283, 283, 283, 0, 283, 283, 283, 283, 0, 0, 0, 0, 0, 0, 0, 0, 0, 0, 0, 0, 0, 0, 0, 0, 0, 0, 203, 203, 204, 0, 0, 0, 0, 0,
201, 0, 0, 0, 0, 267, 283, 283, 283, 0, 283, 283, 283, 283, 0, 0, 0, 0, 0, 202, 202, 202, 202, 202, 202, 202, 202, 202, 203, 202, 0, 0, 0, 0, 202, 202, 202, 202, 202, 204,
201, 0, 0, 0, 0, 267, 283, 283, 283, 0, 283, 283, 283, 283, 0, 0, 0, 0, 0, 204, 0, 0, 0, 0, 0, 0, 0, 0, 0, 201, 0, 0, 0, 0, 0, 0, 0, 0, 0, 204,
201, 0, 0, 0, 0, 0, 0, 0, 0, 0, 0, 0, 0, 0, 0, 0, 0, 0, 0, 204, 0, 0, 0, 0, 0, 0, 0, 0, 0, 201, 0, 0, 0, 0, 0, 0, 0, 0, 0, 204,
201, 0, 0, 0, 0, 0, 0, 0, 0, 0, 0, 0, 0, 0, 0, 0, 0, 0, 0, 204, 0, 0, 0, 0, 0, 0, 0, 0, 0, 201, 0, 0, 0, 0, 0, 0, 0, 0, 0, 204,
201, 0, 0, 0, 0, 0, 0, 0, 0, 0, 0, 0, 0, 0, 0, 0, 0, 0, 0, 204, 0, 0, 0, 0, 0, 0, 0, 0, 0, 201, 0, 0, 0, 0, 206, 209, 0, 0, 0, 204,
201, 0, 0, 0, 0, 0, 0, 0, 0, 0, 0, 0, 0, 0, 0, 0, 0, 0, 0, 204, 0, 0, 0, 0, 0, 0, 0, 0, 0, 205, 206, 206, 206, 207, 0, 201, 0, 0, 0, 204,
201, 0, 227, 0, 0, 227, 0, 0, 0, 0, 0, 227, 0, 0, 227, 0, 0, 0, 0, 203, 203, 203, 203, 203, 203, 203, 203, 203, 203, 203, 204, 0, 0, 0, 0, 201, 0, 0, 0, 204,
201, 0, 245, 0, 0, 245, 0, 0, 0, 0, 0, 245, 0, 0, 245, 0, 0, 0, 0, 0, 0, 0, 0, 0, 0, 0, 0, 0, 0, 0, 204, 0, 0, 0, 0, 201, 0, 0, 0, 204,
201, 0, 0, 0, 0, 0, 0, 0, 0, 0, 0, 0, 0, 0, 0, 0, 0, 0, 0, 227, 0, 227, 0, 0, 227, 0, 227, 0, 0, 0, 204, 0, 0, 0, 0, 201, 0, 0, 0, 204,
201, 0, 0, 0, 0, 0, 0, 0, 0, 0, 0, 0, 0, 0, 0, 0, 0, 0, 0, 245, 0, 245, 0, 0, 245, 0, 245, 0, 0, 0, 204, 0, 0, 0, 0, 201, 0, 0, 0, 204,
201, 0, 0, 0, 0, 0, 0, 0, 0, 0, 0, 0, 0, 0, 0, 0, 0, 0, 0, 0, 0, 0, 0, 0, 0, 0, 0, 0, 0, 0, 204, 0, 0, 0, 0, 201, 0, 0, 0, 204,
201, 0, 0, 0, 0, 0, 0, 0, 0, 0, 0, 0, 0, 0, 0, 0, 0, 0, 0, 0, 0, 0, 0, 0, 0, 0, 0, 0, 0, 0, 204, 0, 0, 0, 0, 201, 0, 0, 0, 204,
201, 0, 0, 0, 0, 0, 0, 0, 0, 0, 0, 0, 0, 0, 0, 0, 0, 0, 0, 0, 0, 0, 0, 0, 0, 0, 0, 0, 0, 0, 204, 0, 0, 0, 0, 201, 0, 0, 0, 204,
201, 0, 0, 0, 0, 0, 0, 0, 0, 0, 0, 0, 0, 0, 0, 0, 0, 0, 0, 0, 0, 0, 0, 0, 0, 0, 0, 0, 0, 0, 204, 0, 0, 0, 0, 201, 0, 0, 0, 204,
201, 0, 0, 0, 0, 0, 0, 0, 0, 0, 0, 0, 0, 0, 0, 0, 0, 0, 0, 0, 0, 0, 0, 0, 0, 0, 0, 0, 0, 0, 204, 0, 0, 0, 0, 201, 0, 0, 0, 204,
201, 0, 227, 0, 0, 227, 0, 0, 0, 0, 0, 227, 0, 0, 227, 0, 0, 0, 0, 227, 0, 0, 227, 0, 0, 227, 0, 0, 227, 0, 204, 0, 0, 0, 0, 201, 0, 0, 0, 204,
201, 0, 245, 0, 0, 245, 0, 0, 0, 0, 0, 245, 0, 0, 245, 0, 0, 0, 0, 245, 0, 0, 245, 0, 0, 245, 0, 0, 245, 0, 204, 0, 0, 0, 0, 201, 0, 0, 0, 204,
201, 0, 0, 0, 0, 0, 0, 0, 0, 0, 0, 0, 0, 0, 0, 0, 0, 0, 0, 0, 0, 0, 0, 0, 0, 0, 0, 0, 0, 0, 204, 0, 0, 0, 0, 201, 0, 0, 0, 204,
201, 0, 0, 0, 0, 0, 0, 0, 0, 0, 0, 0, 0, 0, 0, 0, 0, 0, 0, 0, 0, 0, 0, 0, 0, 0, 0, 0, 0, 0, 204, 201, 202, 202, 202, 202, 0, 0, 0, 204,
201, 0, 0, 0, 0, 0, 0, 0, 0, 0, 0, 0, 0, 0, 0, 0, 0, 0, 0, 0, 0, 0, 0, 0, 0, 0, 0, 0, 0, 0, 204, 201, 0, 0, 0, 225, 0, 0, 0, 204,
201, 0, 0, 0, 0, 0, 0, 0, 0, 0, 0, 0, 0, 0, 0, 0, 0, 0, 0, 0, 0, 0, 0, 0, 0, 0, 0, 0, 0, 0, 204, 201, 0, 225, 0, 243, 0, 0, 0, 204,
201, 0, 0, 0, 0, 0, 0, 0, 0, 0, 0, 0, 0, 0, 0, 0, 0, 0, 0, 0, 0, 0, 0, 0, 0, 0, 0, 0, 0, 0, 204, 201, 0, 243, 0, 0, 0, 225, 0, 204,
201, 0, 0, 0, 0, 0, 0, 0, 0, 0, 0, 0, 0, 0, 0, 0, 0, 0, 0, 0, 0, 0, 0, 0, 0, 0, 0, 0, 0, 0, 204, 201, 0, 225, 0, 0, 0, 243, 0, 204,
201, 0, 0, 0, 0, 0, 0, 0, 0, 0, 0, 0, 0, 0, 0, 0, 0, 0, 0, 0, 0, 0, 0, 0, 0, 0, 0, 0, 0, 0, 204, 201, 0, 243, 0, 0, 225, 0, 0, 204,
201, 0, 0, 0, 0, 0, 0, 0, 0, 0, 0, 0, 0, 0, 0, 0, 0, 0, 0, 0, 0, 0, 0, 0, 0, 0, 0, 0, 0, 0, 204, 201, 0, 0, 0, 0, 243, 0, 0, 204,
205, 206, 207, 207, 207, 207, 207, 207, 207, 206, 207, 207, 207, 207, 207, 207, 207, 207, 207, 207, 207, 207, 207, 207, 207, 207, 207, 207, 206, 207, 208, 205, 207, 207, 207, 207, 207, 207, 207, 208