21, 22, 2, 3, 3, 3, 3, 12, 13, 14,
11, 67, 68, 69, 70, 71, 72, 73, 74, 24,
11, 75, 76, 77, 78, 79, 80, 81, 82, 24,
11, 83, 84, 85, 86, 87, 88, 89, 90, 24,
11, 91, 92, 93, 94, 0, 43, 44, 0, 24,
11, 95, 96, 97, 98, 99, 61, 62, 0, 24,
1, 100, 101, 102, 0, 0, 0, 32, 33, 24,
1, 102, 103, 104, 105, 38, 39, 50, 51, 4,
1, 0, 0, 0, 0, 56, 57, 0, 0, 4,
25, 26, 26, 26, 26, 26, 26, 26, 27, 28